1  1  1  1  1  1  1  1  1  1  1  1  1  1  1  1  1  1  1  1  1  1  1  1  1  1  1  1  1  1  1  1  1  1  1  1  1  1  1  1  1  1  1  1  1  1  1  1
1  10 10 10 10 10 10 10 18 18 10 10 10 10 18 18 10 10 10 10 18 18 10 10 10 10 18 18 10 10 10 10 18 18 10 10 10 10 18 18 10 10 10 10 10 10 10 1
1  10 10 10 10 10 10 10 10 10 10 10 10 10 10 10 10 10 10 10 10 10 10 10 10 10 10 10 10 10 10 10 10 10 10 10 10 10 10 10 10 10 10 10 10 10 10 1
1  10 10 10 10 10 10 10 10 10 10 10 10 10 10 10 10 10 10 10 10 10 10 10 10 10 10 10 10 10 10 10 10 10 10 10 10 10 10 10 10 10 10 10 10 10 10 1
1  10 10 10 99 10 10 10 10 10 10 10 10 10 10 10 10 10 10 10 10 10 10 10 10 10 10 10 10 10 10 10 10 10 10 10 10 10 10 10 10 10 10 10 10 10 10 1
1  10 10 10 1  17 17 1  1  1  1  17 17 1  1  1  1  17 17 1  1  1  1  17 17 1  1  1  1  17 17 1  1  1  1  17 17 1  1  1  1  17 17 1  1  1  1  1
1  10 10 10 1  1  1  1  1  1  1  1  1  1  1  1  1  1  1  1  1  1  1  1  1  1  1  1  1  1  1  1  1  1  1  1  1  1  1  1  1  1  1  1  1  1  1  1
1  10 1  10 10 10 10 10 10 1  10 10 10 10 1  10 10 10 10 1  10 10 10 10 1  10 10 10 10 1  10 10 10 10 1  10 10 10 10 1  10 10 10 10 10 10 10 1
10 10 10 10 10 10 10 10 10 1  10 10 10 10 1  10 10 10 10 1  10 10 10 10 1  10 10 10 10 1  10 10 10 10 1  10 10 10 10 1  10 10 10 10 10 10 10 1
10 10 10 10 10 10 10 10 10 1  10 10 10 10 1  10 10 10 10 1  10 10 10 10 1  10 10 10 10 1  10 10 10 10 1  10 10 10 10 1  10 10 10 10 10 10 10 1
10 10 10 10 10 10 10 10 10 10 10 10 10 10 10 10 10 10 10 10 10 10 10 10 10 10 10 10 10 10 10 10 10 10 10 10 10 10 10 10 10 10 10 10 10 10 10 1
1  1  1  1  1  1  17 17 1  1  1  17 17 1  1  1  17 17 1  1  1  17 17 1  1  1  17 17 1  1  1  17 17 1  1  1  17 17 1  1  1  17 17 1  10 10 10 1
1  1  1  1  1  1  1  1  1  1  1  1  1  1  1  1  1  1  1  1  1  1  1  1  1  1  1  1  1  1  1  1  1  1  1  1  1  1  1  1  1  1  1  1  10 10 10 1
1  10 10 10 10 10 10 10 10 10 10 10 10 10 10 10 10 10 10 10 10 10 10 10 10 10 10 10 10 10 10 10 10 10 10 10 10 10 10 10 10 10 10 10 10 1  10 1
1  10 10 10 10 10 10 10 10 10 10 10 10 10 10 10 10 10 10 10 10 10 10 10 10 10 10 10 10 10 10 10 10 10 10 10 10 10 10 10 10 10 10 10 10 10 10 10
1  10 10 10 10 10 10 10 10 10 10 10 10 10 10 10 10 10 10 10 10 10 10 10 10 10 10 10 10 10 10 10 10 10 10 10 10 10 10 10 10 10 10 10 10 10 10 10
1  10 10 10 10 10 10 10 10 10 10 10 10 10 10 10 10 10 10 10 10 10 10 10 10 10 10 1  10 10 10 10 10 1  10 10 10 10 10 10 10 10 10 10 10 10 10 10
1  1  10 10 1  1  10 10 1  10 10 1  10 10 1  10 10 1  1  10 10 1  10 10 1  10 10 10 10 10 1  10 10 10 10 10 1  1  10 10 10 1  1  1  1  1  1  1
1  10 10 10 1  10 10 10 1  10 10 1  10 10 1  10 10 10 1  10 10 10 10 10 10 10 10 10 10 10 10 10 10 10 10 10 10 1  10 10 10 1  10 10 10 1  1  1
1  10 10 1  1  10 10 10 1  10 10 1  10 10 1  10 10 10 1  1  10 10 10 10 10 10 10 10 10 10 10 10 10 10 10 10 10 1  10 10 10 1  10 10 10 11 10 1
1  10 10 10 1  17 17 17 1  17 17 1  1  17 1  17 17 17 1  10 10 17 17 17 17 17 17 17 17 17 17 17 17 17 17 17 17 1  17 17 17 1  1  1  1  1  10 1
1  10 10 10 10 10 10 10 10 10 10 10 10 10 10 10 10 10 1  10 10 10 10 10 10 10 10 10 10 10 10 10 10 10 10 10 10 10 10 10 10 21 21 10 10 10 10 1