0  0  0  0  0  1  0  0  0  0  0  0  0  0  0  0  0  0  0  0  0  0  0  0  0  0  0  0  0  0  0  0  0  0  0  0  0  0  0  0  0  0  1  0  0  0  0  0  0  0  0  0  0  1  0  0  0  0  0  0  0  0  0  0
0  0  0  2  0  1  0  0  2  0  0  0  0  0  0  0  0  0  0  0  0  0  0  0  0  0  0  0  0  0  0  0  0  0  0  0  0  0  2  0  0  0  1  0  2  0  0  2  0  0  0  0  0  1  0  0  0  0  0  0  0  0  0  0
2  2  2  2  0  1  0  0  0  0  1  1  0  0  0  0  0  0  0  0  0  0  0  0  0  0  0  0  0  0  0  0  0  0  0  0  0  0  0  0  0  0  1  0  0  0  2  0  0  2  0  0  0  1  0  0  0  0  0  0  0  0  0  0
0  0  0  2  0  1  2  0  0  0  0  1  0  2  2  2  0  0  0  0  0  0  1  0  0  0  2  0  0  0  0  0  0  0  0  0  0  0  0  2  0  0  1  0  0  0  0  0  0  0  0  0  0  1  0  0  0  0  0  0  0  0  0  0
0  0  0  0  0  1  0  2  0  0  0  1  0  0  0  0  0  0  0  0  0  0  0  1  0  2  0  0  0  0  0  0  0  0  0  2  0  0  2  0  0  0  1  0  0  0  0  0  0  0  0  2  0  1  0  0  0  0  0  1  0  0  0  0
2  2  2  2  0  1  0  0  0  0  0  1  2  0  0  0  0  2  2  2  0  0  0  1  0  0  0  0  0  0  0  0  2  0  0  0  0  0  0  0  0  0  1  0  0  0  2  2  0  2  0  0  0  1  0  0  99 0  1  1  1  0  0  0
0  0  2  0  0  1  0  0  0  2  2  1  0  0  0  0  0  0  0  0  0  0  0  1  0  0  0  0  0  2  0  0  0  0  0  0  0  0  0  0  0  0  1  0  2  0  0  0  0  0  0  0  0  1  0  0  0  1  1  1  1  1  0  0
0  0  0  0  0  1  0  0  0  0  0  1  7  7  7  7  7  7  7  7  7  7  0  1  0  0  0  0  0  0  0  0  0  0  0  0  0  0  0  0  0  0  1  0  0  0  0  0  0  0  0  0  0  1  0  0  10 10 1  1  1  1  1  0
2  2  2  12 2  2  2  2  2  2  2  2  2  2  2  2  2  2  2  2  2  2  22 2  2  2  2  2  2  2  2  2  2  2  2  2  2  2  2  2  2  2  2  12 12 12 2  12 12 12 12 12 12 2  2  2  2  2  2  2  2  2  2  2
2  2  12 12 12 12 2  12 12 12 12 2  2  2  2  2  2  12 12 12 2  2  12 12 12 2  2  2  2  2  2  2  2  2  2  2  12 12 12 12 2  2  2  12 12 12 12 12 2  2  12 12 12 2  2  2  2  2  2  2  2  2  2  2
2  12 12 2  2  12 12 12 2  2  12 12 2  2  12 12 2  2  2  12 2  2  2  2  2  2  2  2  2  2  12 12 12 12 12 2  12 2  2  12 2  2  2  12 12 12 12 12 12 12 12 12 12 2  2  2  2  2  2  2  2  2  2  2
2  12 2  2  2  2  2  12 12 2  2  2  2  2  12 2  2  12 12 12 12 12 2  2  2  2  2  2  2  12 12 2  12 2  12 2  2  2  12 12 2  12 2  2  2  2  2  2  2  2  2  2  2  2  2  2  2  2  2  2  2  2  2  2
2  12 12 12 2  2  2  2  12 12 2  12 12 12 12 12 12 12 2  2  2  12 12 2  2  12 12 12 2  12 2  2  12 2  12 12 12 2  12 2  2  12 12 2  2  12 12 12 12 12 12 12 2  2  2  2  2  2  2  2  2  2  2  2
2  2  2  12 12 12 2  2  2  2  2  12 2  2  2  12 2  2  2  2  2  2  12 12 12 12 2  12 12 12 2  12 12 2  2  2  12 12 12 2  2  2  12 2  2  2  2  2  12 2  2  2  2  2  2  2  2  2  2  2  2  2  2  2
2  12 12 12 2  12 12 12 12 12 12 12 2  2  2  12 12 12 2  12 12 2  2  12 2  2  2  2  2  2  2  12 2  2  2  2  2  2  12 12 12 12 12 2  2  2  2  2  12 2  2  2  2  2  2  2  2  2  2  2  2  2  2  2
2  2  2  2  2  2  2  2  2  2  2  2  2  2  2  2  2  2  2  2  12 12 12 12 2  2  2  2  2  12 12 12 2  2  2  2  2  2  2  2  2  2  12 12 12 12 12 12 12 2  2  2  2  2  2  2  2  2  2  2  2  2  2  2