0  0  0  0  0  1  0  0  0  0  0  0  0  0  0  0  0  0  0  0  0  0  0  0  0  0  0  0  0  0  0  0  0  0  0  0  0  0  0  0  0  0  1  0  0  0  0  0  0  0  0  0  0  1  0  0  0  0  0  0  0  0  0  0
0  0  0  2  0  1  0  0  13 0  0  0  0  0  0  0  0  0  0  0  0  0  0  0  0  0  0  0  0  0  0  0  0  0  0  0  0  0  13 0  0  0  1  0  13 0  0  13 0  0  0  0  0  1  0  0  0  0  0  0  0  0  0  0
2  2  2  2  0  1  0  0  0  0  1  1  0  0  0  0  0  0  0  0  0  0  0  0  0  0  0  0  0  0  0  0  0  0  0  0  0  0  0  0  0  0  1  0  0  0  13 0  0  13 0  0  0  1  0  0  0  0  0  0  0  0  0  0
0  0  0  2  0  1  13 0  0  0  0  1  0  13 13 13 0  0  0  0  0  0  13 0  0  0  13 0  0  0  0  0  0  0  0  0  0  0  0  13 0  0  1  0  0  0  0  0  0  0  0  0  0  1  0  0  0  0  0  0  0  0  0  0
0  0  0  0  0  1  0  13 0  0  0  1  0  0  0  0  0  0  0  0  0  0  0  13 0  13 0  0  0  0  0  0  0  0  0  13 0  0  13 0  0  0  1  0  0  0  0  0  0  0  0  2  0  1  0  0  0  0  0  1  0  0  0  0
2  2  2  2  0  1  0  0  0  0  0  1  2  0  0  0  0  13 13 13 0  0  0  2  0  0  0  0  0  0  0  0  13 0  0  0  0  0  0  0  0  0  1  0  0  0  13 13 0  2  0  0  0  1  0  0  0  0  1  1  1  0  0  0
0  0  2  0  0  1  0  0  0  13 13 1  0  0  0  0  0  0  0  0  0  0  0  2  0  0  0  0  0  13 0  0  0  0  0  0  0  0  0  0  0  0  1  0  13 0  0  0  0  0  0  0  0  1  0  0  0  1  1  1  1  1  0  0
0  0  0  0  0  1  99 0  0  0  0  1  7  7  7  7  7  7  7  7  7  7  7  2  0  0  0  0  0  0  0  0  0  0  0  0  0  0  0  0  0  0  1  0  0  0  0  0  0  0  0  0  0  1  0  0  10 10 1  1  1  1  1  0
13 13 13 12 13 13 13 13 13 13 13 13 13 13 13 13 13 13 13 13 13 13 13 13 13 13 13 13 13 13 13 13 13 13 13 13 13 13 13 13 13 13 13 12 12 12 13 12 12 12 12 12 12 13 13 13 13 13 13 13 13 13 13 13
2  2  12 12 12 12 2  12 12 12 12 2  2  2  2  2  2  12 12 12 2  2  12 12 12 2  2  2  2  2  2  2  2  2  2  2  12 12 12 12 2  2  2  12 12 12 12 12 2  2  12 12 12 2  2  2  2  2  2  2  2  2  2  2
2  12 12 2  2  12 12 12 2  2  12 12 2  2  12 12 2  2  2  12 2  22 12 2  2  2  2  2  2  2  12 12 12 12 12 2  12 2  2  12 2  2  2  12 12 12 12 12 12 12 12 12 12 2  2  2  2  2  2  2  2  2  2  2
2  12 2  2  2  2  2  12 12 2  2  2  2  2  12 2  2  12 12 12 12 12 2  2  2  2  2  2  2  12 12 2  12 2  12 2  2  2  12 12 2  12 2  2  2  2  2  2  2  2  2  2  2  2  2  2  2  2  2  2  2  2  2  2
2  12 12 12 2  2  2  2  12 12 2  12 12 12 12 12 12 12 2  2  2  12 12 2  2  12 12 12 2  12 2  2  12 2  12 12 12 2  12 2  2  12 12 2  2  12 12 12 12 12 12 12 2  2  2  2  2  2  2  2  2  2  2  2
2  2  2  12 12 12 2  2  2  2  2  12 2  2  2  12 2  2  2  2  2  2  12 12 12 12 2  12 12 12 2  12 12 2  2  2  12 12 12 2  2  2  12 2  2  2  2  2  12 2  2  2  2  2  2  2  2  2  2  2  2  2  2  2
2  12 12 12 2  12 12 12 12 12 12 12 2  2  2  12 12 12 2  12 12 2  2  12 2  2  2  2  2  2  2  12 2  2  2  2  2  2  12 12 12 12 12 2  2  2  2  2  12 2  2  2  2  2  2  2  2  2  2  2  2  2  2  2
2  2  2  2  2  2  2  2  2  2  2  2  2  2  2  2  2  2  2  2  12 12 12 12 2  2  2  2  2  2  2  !2 12 12 12 12 12 2  2  2  2  2  12 12 12 12 12 12 12 2  2  2  2  2  2  2  2  2  2  2  2  2  2  2