1  1  1  1  1  1  1  1  1  1  1  1  1  1  1  1  1  1  1  1  1  1  1  1  1  1  1  1  1  1  1  1  1  1  1  1  1  1  1  1  1  1  1  1  1  1  1  1
1  10 10 11 10 1  1  1  1  1  1  1  1  1  10 10 1  1  1  1  10 10 9  10 10 1  1  1  11 10 1  1  1  1  1  1  1  1  1  1  1  1  1  1  1  1  1  1
1  1  1  1  10 1  1  1  1  1  1  1  1  1  10 1  1  10 10 10 11 10 11 10 11 10 1  1  1  10 10 1  1  1  10 10 10 11 10 10 10 10 11 10 10 10 10 1
1  1  1  1  10 10 11 10 10 10 11 10 10 10 11 1  1  10 1  1  10 10 10 10 10 1  1  1  1  1  10 10 10 1  10 1  1  1  1  1  1  1  1  1  1  1  10 1
1  1  1  1  1  10 1  1  1  1  10 1  1  1  1  1  1  11 10 1  1  1  1  1  1  1  1  1  1  1  1  1  10 10 10 10 11 10 1  1  1  1  1  1  1  1  10 1
1  1  10 11 10 10 1  1  1  1  10 10 10 11 10 10 1  1  10 1  1  1  1  1  1  1  1  1  1  1  1  1  1  1  1  1  1  10 1  1  1  1  1  1  1  1  1  1
1  1  10 1  1  1  1  1  1  1  1  1  10 1  1  10 1  1  10 1  10 10 10 10 10 10 10 10 10 10 1  1  1  10 10 10 11 10 10 10 1  1  1  1  1  1  1  1
1  1  10 10 1  1  1  1  1  1  1  1  10 1  1  10 10 1  11 10 10 10 10 10 10 10 10 10 10 10 10 10 10 10 1  1  1  1  1  10 10 10 11 10 1  1  1  1
1  1  1  1  1  10 10 10 11 10 10 10 11 10 1  1  10 1  1  1  11 11 11 11 11 11 11 11 11 11 1  1  1  1  1  1  1  1  1  1  1  1  1  1  1  1  1  1
1  1  1  1  1  10 1  1  1  1  1  1  1  10 1  1  10 10 10 10 10 10 10 10 10 10 10 10 10 10 10 10 10 10 11 10 1  1  1  1  1  1  1  1  1  1  1  1
1  1  1  10 10 10 1  1  1  1  1  1  1  10 1  1  1  1  1  1  1  1  1  1  10 10 10 1  1  1  1  1  10 1  1  10 10 10 10 11 1  1  10 11 10 10 1  1
1  1  1  1  1  1  1  1  1  1  10 10 10 11 1  1  1  1  1  1  1  1  1  1  1  10 1  1  1  1  1  1  10 1  1  1  10 1  1  10 1  1  10 1  1  10 1  1
1  1  1  1  1  11 10 10 10 11 10 1  1  1  1  1  1  1  1  1  1  1  1  1  1  10 1  1  1  1  1  1  11 10 10 10 11 1  1  10 10 11 10 1  1  10 1  1
1  1  1  1  1  10 1  1  1  1  10 10 10 1  1  10 10 10 10 1  1  1  1  1  10 10 10 1  1  1  1  1  1  1  1  1  1  1  11 10 1  1  1  1  1  11 10 1
1  1  1  1  1  10 1  1  1  1  1  1  10 1  1  10 1  1  10 10 10 1  1  1  10 1  10 1  1  1  1  1  1  1  1  1  1  1  10 1  1  1  1  1  1  1  10 1
1  1  1  1  10 10 1  11 10 10 10 11 10 1  1  10 1  1  1  1  1  1  1  1  10 1  10 1  1  1  1  1  10 10 1  1  1  11 10 1  1  1  1  1  10 10 11 1
1  1  1  1  10 1  1  1  1  1  1  1  1  1  1  10 10 1  1  1  1  1  1  10 11 1  11 10 1  1  1  1  1  10 10 10 1  10 1  1  1  1  1  1  1  1  1  1
1  1  1  1  11 10 10 10 11 1  1  1  1  1  1  1  10 1  1  1  1  1  1  10 1  1  1  10 1  1  1  1  1  1  1  10 1  10 10 11 10 10 1  10 10 1  1  1
1  1  1  1  1  1  1  1  1  1  1  1  1  1  1  1  10 1  1  1  1  1  1  10 1  1  1  10 1  1  1  1  1  1  1  10 1  1  1  1  1  1  1  10 1  1  1  1
1  1  1  1  1  1  1  10 10 10 1  1  1  1  1  10 10 10 10 11 10 10 10 11 10 11 10 11 10 10 10 11 10 10 10 11 1  1  1  1  1  10 10 10 1  1  1  1
1  1  1  1  1  1  1  1  1  10 10 1  1  1  10 10 1  1  1  1  1  1  1  1  1  10 1  1  1  1  1  1  10 1  1  1  1  1  1  1  1  10 1  1  1  1  1  1
1  1  1  1  1  1  1  1  1  1  10 10 10 10 10 1  1  1  1  1  1  1  1  1  1  10 1  1  1  1  1  1  10 10 10 1  1  10 10 10 10 10 1  1  1  1  1  1
1  1  1  1  1  10 10 10 1  1  1  10 1  1  1  1  10 10 10 10 10 10 10 10 10 10 1  1  1  1  1  1  1  1  10 10 10 10 1  10 1  1  1  1  1  1  1  1
1  1  1  1  1  1  1  10 1  1  1  10 1  1  10 10 10 1  1  1  1  1  1  1  1  1  1  1  1  1  1  1  1  1  1  1  1  1  1  10 10 10 10 1  1  1  1  1
1  1  1  1  1  1  1  10 10 10 10 10 1  10 10 1  1  1  1  1  1  1  1  1  1  1  1  1  1  1  1  1  1  1  1  1  1  1  1  1  1  1  10 10 10 10 1  1
1  1  1  1  1  1  1  1  1  1  1  1  1  10 1  1  1  1  1  1  1  1  1  1  1  1  1  1  1  1  1  1  1  1  1  1  1  1  1  1  1  1  1  1  1  1  1  1
1  1  1  1  1  1  10 10 10 10 10 10 10 10 1  1  1  10 10 10 10 10 10 10 10 10 10 10 10 10 10 10 10 10 10 10 1  1  1  1  1  1  1  1  1  1  1  1
1  1  1  1  1  1  10 1  1  1  1  1  1  1  1  1  1  11 11 11 11 11 11 11 11 11 11 11 11 11 11 11 11 11 11 11 1  1  1  1  1  1  1  1  1  1  1  1
1  1  1  1  1  1  10 10 1  1  10 10 10 10 10 3  1  10 10 10 10 10 10 10 10 10 10 10 10 10 10 10 10 10 10 10 1  1  1  10 10 10 99 1  1  1  1  1
1  1  1  1  1  1  1  10 10 1  10 11 11 11 1  1  1  11 11 11 11 11 11 11 11 11 11 11 11 11 11 11 11 11 11 11 1  1  1  11 11 11 11 1  1  1  1  1
1  1  1  1  1  1  1  1  10 10 10 10 10 10 10 10 10 10 10 10 10 10 10 10 10 10 10 10 10 10 10 10 10 10 10 10 10 10 10 10 10 10 1  1  1  1  1  1
1  1  1  1  1  1  1  1  1  1  1  1  1  1  1  1  1  1  1  1  1  1  1  1  1  1  1  1  1  1  1  1  1  1  1  1  1  1  1  1  1  1  1  1  1  1  1  1